[
  {
    "method": "json",
    "om_terrain": "ruined_house_1_0",
    "type": "mapgen",
    "weight": 100,
    "object": {
      "fill_ter": "t_region_groundcover",
      "rows": [
        "........................",
        "..###=##=#].............",
        "..#::::::...............",
        "..=:<:::................",
        "..#::::.....##=##]]####.",
        "..#:::......#::::..:::#.",
        "..=::.......#::....:::=.",
        "..#:........].......::#.",
        "..].................::#.",
        "....................::#.",
        "............]........:=.",
        "..].......].#:.......:#.",
        "..#:.....:#.#::......:#.",
        "..#::...::=.#:::......].",
        "..#=#].]###.####].......",
        "........................",
        "........................",
        "......................].",
        "....................::#.",
        "................:::.::#.",
        "............::::::::::=.",
        "...........::::<::::::#.",
        "..........]##=###=##=##.",
        "........................"
      ],
      "palettes": [ "grimdark_ruined_house_lower" ]
    }
  },
  {
    "method": "json",
    "om_terrain": "ruined_house_1_1",
    "type": "mapgen",
    "weight": 100,
    "object": {
      "fill_ter": "t_region_groundcover",
      "rows": [
        "........................",
        "..###=##=#].............",
        "..#::::::...............",
        "..=:>:::................",
        "..#::::.....##=##]]####.",
        "..#:::......#::::..:::#.",
        "..=::.......#::....:::=.",
        "..#:........].......::#.",
        "..].................::#.",
        "....................::#.",
        "............]........:=.",
        "..].......].#:.......:#.",
        "..#:.....:#.#::......:#.",
        "..#::...::=.#:::......].",
        "..#=#].]###.####].......",
        "........................",
        "........................",
        "......................].",
        "....................::#.",
        "................:::.::#.",
        "............::::::::::=.",
        "...........::::>::::::#.",
        "..........]##=###=##=##.",
        "........................"
      ],
      "palettes": [ "grimdark_ruined_house_upper" ]
    }
  }
]
