[
  {
    "method": "json",
    "om_terrain": "coaching_inn_outer_wall_corner_0",
    "type": "mapgen",
    "weight": 100,
    "object": {
      "fill_ter": "t_region_groundcover_forest",
      "rows": [
        ",,,,,,,,,,,,,,,,,,,,,,,,",
        ",,,,,,,,,,,,,,,,,,,,,,,,",
        ",,,,,,,,,,,,,,,,,,,,,,,,",
        ",,,,,,,,,,,,,,,,,,,,,,,,",
        ",,,,,,,,,,,,,,,,,,,,,,,,",
        ",,,,,,,,,,,,,,,,,,,,,,,,",
        ",,,,,,,,,,,,,,,,,,,,,,,,",
        ",,,,,,,,,,,,,,,,,,,,,,,,",
        ",,,,,,,,,,,,,,,,,,,,,,,,",
        ",,,,,,,,,#####,,,,,,,,,,",
        ",,,,,,,,,###############",
        ",,,,,,,,,###############",
        ",,,,,,,,,###############",
        ",,,,,,,,,#####..........",
        ",,,,,,,,,,###...........",
        ",,,,,,,,,,###...........",
        ",,,,,,,,,,###...........",
        ",,,,,,,,,,###...........",
        ",,,,,,,,,,###...........",
        ",,,,,,,,,,###...........",
        ",,,,,,,,,,###...........",
        ",,,,,,,,,,###...........",
        ",,,,,,,,,,###...........",
        ",,,,,,,,,,###..........."
      ],
      "palettes": [ "grimdark_coaching_inn_wall_lower" ]
    }
  },
  {
    "method": "json",
    "om_terrain": "coaching_inn_outer_wall_corner_1",
    "type": "mapgen",
    "weight": 100,
    "object": {
      "fill_ter": "t_region_groundcover_forest",
      "rows": [
        "........................",
        "........................",
        "........................",
        "........................",
        "........................",
        "........................",
        "........................",
        "........................",
        "........................",
        ".........#####..........",
        ".........###############",
        ".........###############",
        ".........###############",
        ".........#####..........",
        "..........###...........",
        "..........###...........",
        "..........###...........",
        "..........###...........",
        "..........###...........",
        "..........###...........",
        "..........###...........",
        "..........###...........",
        "..........###...........",
        "..........###..........."
      ],
      "palettes": [ "grimdark_coaching_inn_wall_upper" ]
    }
  },
  {
    "method": "json",
    "om_terrain": "coaching_inn_outer_wall_corner_2",
    "type": "mapgen",
    "weight": 100,
    "object": {
      "fill_ter": "t_region_groundcover_forest",
      "rows": [
        "........................",
        "........................",
        "........................",
        "........................",
        "........................",
        "........................",
        "........................",
        "........................",
        "........................",
        ".........#####..........",
        ".........###############",
        ".........###############",
        ".........###############",
        ".........#####..........",
        "..........###...........",
        "..........###...........",
        "..........###...........",
        "..........###...........",
        "..........###...........",
        "..........###...........",
        "..........###...........",
        "..........###...........",
        "..........###...........",
        "..........###..........."
      ],
      "palettes": [ "grimdark_coaching_inn_wall_top" ]
    }
  },
  {
    "method": "json",
    "om_terrain": "coaching_inn_outer_wall_0",
    "type": "mapgen",
    "weight": 100,
    "object": {
      "fill_ter": "t_region_groundcover_forest",
      "rows": [
        ",,,,,,,,,,###...........",
        ",,,,,,,,,,###...........",
        ",,,,,,,,,,###...........",
        ",,,,,,,,,,###...........",
        ",,,,,,,,,,###...........",
        ",,,,,,,,,,###...........",
        ",,,,,,,,,,###...........",
        ",,,,,,,,,,###...........",
        ",,,,,,,,,,###...........",
        ",,,,,,,,,,###...........",
        ",,,,,,,,,,###...........",
        ",,,,,,,,,,###...........",
        ",,,,,,,,,,###...........",
        ",,,,,,,,,,###...........",
        ",,,,,,,,,,###...........",
        ",,,,,,,,,,###...........",
        ",,,,,,,,,,###...........",
        ",,,,,,,,,,###...........",
        ",,,,,,,,,,###...........",
        ",,,,,,,,,,###...........",
        ",,,,,,,,,,###...........",
        ",,,,,,,,,,###...........",
        ",,,,,,,,,,###...........",
        ",,,,,,,,,,###..........."
      ],
      "palettes": [ "grimdark_coaching_inn_wall_lower" ]
    }
  },
  {
    "method": "json",
    "om_terrain": "coaching_inn_outer_wall_1",
    "type": "mapgen",
    "weight": 100,
    "object": {
      "fill_ter": "t_region_groundcover_forest",
      "rows": [
        "..........###...........",
        "..........###...........",
        "..........###...........",
        "..........###...........",
        "..........###...........",
        "..........###...........",
        "..........###...........",
        "..........###...........",
        "..........###...........",
        "..........###...........",
        "..........###...........",
        "..........###...........",
        "..........###...........",
        "..........###...........",
        "..........###...........",
        "..........###...........",
        "..........###...........",
        "..........###...........",
        "..........###...........",
        "..........###...........",
        "..........###...........",
        "..........###...........",
        "..........###...........",
        "..........###..........."
      ],
      "palettes": [ "grimdark_coaching_inn_wall_upper" ]
    }
  },
  {
    "method": "json",
    "om_terrain": "coaching_inn_outer_wall_2",
    "type": "mapgen",
    "weight": 100,
    "object": {
      "fill_ter": "t_region_groundcover_forest",
      "rows": [
        "..........###...........",
        "..........###...........",
        "..........###...........",
        "..........###...........",
        "..........###...........",
        "..........###...........",
        "..........###...........",
        "..........###...........",
        "..........###...........",
        "..........###...........",
        "..........###...........",
        "..........###...........",
        "..........###...........",
        "..........###...........",
        "..........###...........",
        "..........###...........",
        "..........###...........",
        "..........###...........",
        "..........###...........",
        "..........###...........",
        "..........###...........",
        "..........###...........",
        "..........###...........",
        "..........###..........."
      ],
      "palettes": [ "grimdark_coaching_inn_wall_top" ]
    }
  },
  {
    "method": "json",
    "om_terrain": "coaching_inn_outer_wall_gate_0",
    "type": "mapgen",
    "weight": 100,
    "object": {
      "fill_ter": "t_region_groundcover_forest",
      "rows": [
        ",,,,,,,,,,###...........",
        ",,,,,,,,,,###...........",
        ",,,,,,,,,,###...........",
        ",,,,,,,,,,###...........",
        ",,,,,,,,,,###...........",
        ",,,,,,,,,,###...........",
        ",,,,,,,,,,###...........",
        ",,,,,,,,,,###...........",
        ",,,,,,,,,,###...........",
        ",,,,,,,,,,###...........",
        ",,,,,,,,,,#|@...........",
        ",,,,,,,,,,,+............",
        ",,,,,,,,,,,+............",
        ",,,,,,,,,,#|............",
        ",,,,,,,,,,###...........",
        ",,,,,,,,,,###...........",
        ",,,,,,,,,,###...........",
        ",,,,,,,,,,###...........",
        ",,,,,,,,,,###...........",
        ",,,,,,,,,,###...........",
        ",,,,,,,,,,###...........",
        ",,,,,,,,,,###...........",
        ",,,,,,,,,,###...........",
        ",,,,,,,,,,###..........."
      ],
      "palettes": [ "grimdark_coaching_inn_wall_lower" ]
    }
  },
  {
    "method": "json",
    "om_terrain": "coaching_inn_outer_wall_gate_1",
    "type": "mapgen",
    "weight": 100,
    "object": {
      "fill_ter": "t_region_groundcover_forest",
      "rows": [
        "..........###...........",
        "..........###...........",
        "..........###...........",
        "..........###...........",
        "..........###...........",
        "..........###...........",
        "..........###...........",
        "..........###...........",
        "..........###...........",
        "..........###...........",
        "..........###...........",
        "..........###...........",
        "..........###...........",
        "..........###...........",
        "..........###...........",
        "..........###...........",
        "..........###...........",
        "..........###...........",
        "..........###...........",
        "..........###...........",
        "..........###...........",
        "..........###...........",
        "..........###...........",
        "..........###..........."
      ],
      "palettes": [ "grimdark_coaching_inn_wall_upper" ]
    }
  },
  {
    "method": "json",
    "om_terrain": "coaching_inn_outer_wall_gate_2",
    "type": "mapgen",
    "weight": 100,
    "object": {
      "fill_ter": "t_region_groundcover_forest",
      "rows": [
        "..........###...........",
        "..........###...........",
        "..........###...........",
        "..........###...........",
        "..........###...........",
        "..........###...........",
        "..........###...........",
        "..........###...........",
        "..........###...........",
        "..........###...........",
        "..........###...........",
        "..........###...........",
        "..........###...........",
        "..........###...........",
        "..........###...........",
        "..........###...........",
        "..........###...........",
        "..........###...........",
        "..........###...........",
        "..........###...........",
        "..........###...........",
        "..........###...........",
        "..........###...........",
        "..........###..........."
      ],
      "palettes": [ "grimdark_coaching_inn_wall_top" ]
    }
  }
]
